R 1080 720
NO ./textures/brick.xpm
SO ./textures/blue.xpm
WE ./textures/green_wood.xpm
EA ./textures/grey.xpm

S ./textures/chalice.xpm
F 255,255,67
C 205,60,60

11111111111111111111111111111
10000S00001100000000222000001
10110000011100020000202010001
10120000000000000000202010001
10110000011120000000202010001
10002220001120000111212110001
11110111111121110110202010001
11110111111120011101010000001
11000000110121011000000000001
10002000000020000000000000001
10000000000020001101010010001
11000000110101011111011110001
11110111111101011111011110001
11111111111111111111111111111